F 20,3,128
C 20,8,23

NO ./images/fchkel_wall.xpm
SO ./images/red_wall.xpm
WE ./images/blue_wall.xpm
EA ./images/grey_wall.xpm

                                111111111111
111111111111111111111111111111111110111000011
10000000000000000000000000000000000001010001
1000000000000000000000000000000000000000S101
100000000000000000000000000000000001100000001
111111111111111111111111111111111111 11111111