
  111111
1110010111
   1100N1
     1