WE ./images/blue_wall.xpm
NO ./images/fchkel_wall.xpm
EA ./images/grey_wall.xpm
SO ./images/red_wall.xpm

C 205,128,230

F 0,3,128

        11111111111111111111111111
        100000000011000000000000001111111
        101100000111000000000000101
        100100000000000000000000101
11111111101100000111000000000000101
1000000000110000011101111111111111
11110111111111011100000010001
11110111111111011101010010001
11000000110101011100000000001
100000S00000000000000100000001
100000000000000001101010000001
110000011101010111110111000011
1100011111101011 111110100011
11111111 1111111 111111111111