WE ./images/mait-jao.xpm
NO ./images/sriyani.xpm
EA ./images/ael-asri.xpm
SO ./images/mbadaoui.xpm

C 205,0,230

F 128,128,128

        1111111111111111111111111
        1000000000110000000000001
        1011000001110000000000001
        1001000000000000000000001
111111111011000001110000000000001
100000000011000001110111111111111
11110111111111011100000010001
11110111111111011101010010001
11000000110101011100000000001
100000E00000000000000100000001
10000000000000001101010000001
1100000111010101111101110000111
1100011111101011 111110100011
11111111 1111111 111111111111