NO ./images/fchkel_wall.xpm
SO ./images/red_wall.xpm
WE ./images/blue_wall.xpm
EA ./images/grey_wall.xpm

F 10,+30,+0
C +26,30,0

        1111111111111111111111111
        1000000000110000000000001
        1011000001110000000000001
        100100000000000001000000111111111111
111111111011000001110000000000001111111111111
100000000011000000111011111111111111111101111
11110111111111011100000010001111111111111
11110111111111011101010010001
11000000110101011100000010001
10000S00000000001100000010001
10000000000000011010100100011   1
110000011101010111110111100111111
11110111 1110101 1011101111001  1
11111111 1111111 111111111111