      
      
      
      
        1111111  111111111111111111
        100000011000000000000111
        1011000001110000000000001
        111111111111111111111111
                11 11 11 11
                11 11 11 11
