



C 20,8,23

WE ./images/blue_wall.xpm
NO ./images/fchkel_wall.xpm
EA ./images/grey_wall.xpm
SO ./images/red_wall.xpm

F 20,3,128

        11111111111111111111111111
        100000000011000000000000011111
        101100000111000000000000001
        100100000000000000000000101
11111111101100000111000000000000101
10000000001100000111011111111111111
11110111111111011100000010001
11110111111111111101010010001
110000001101010111000000000011
1000000W00000000000000100000001
100000000000000001101010000001
110000010101010111110111000011
1100011111111011 111110100011
1111111111111111111111111111
11111111   11111 111111111111