NO ./images/mait-jao.xpm
SO ./images/wall.xpm
WE ./images/elgato.xpm
EA ./images/floor.xpm

F 250,0,0
C 205,0,230

        
        1111111111111111111111111
        1000000000110000000000001
        1011000001110000000000001
        1001000000000000000000001
111111111011000001110000000000001
100000000011000001110111111111111
11110111111111011100000010001
11110111111111011101010010001
11000000110101011100000000001
1000E000000000001100000000101
10000000000000001101010000001
1100000111010101111101110000111
11110111 1110101 101111010001 
11111111 1111111 111111111111