NO ./images/sriyani.xpm
SO ./images/mait-jao.xpm
WE ./images/elgato.xpm
EA ./images/theRock.xpm





F 250,0,0
C 205,0,230


        1111111111111111111111111
        1000000000110000000000001
        1011000001110000000000001
        1001000000000000000000001
111111111011000001110000000000001
100000000W11000001110111111111111
11010111111111011100000010001
11110111111111011101010010001
11000000110101011100000000001
10001000000000001100000000101
1000000000001001101010000001
1100000111010101111101110000111
11110111 1110101 101111010001
11111111 1111111 111111111111