
C 205,128,230

WE        ./images/blue_      wall.xpm
NO        ./images/fchkel_wall.xpm
EA        ./images/grey_wall.xpm
SO        ./images/red_wall.xpm

F 0000000000000000,3,128



        11111111111111111111111111
        100000000011000000000000001111111
        1011000001110000001000000101
        100100000000000000000000101111111
		111111111011011111111000111000001
		10000000001101111111100011101111111111111
		111101111111111111111011100000010001
		111101111111111111111011101010010001
		110000001101011111111011100000000001
		100000W000000111111110000000100000001
		1000000000000111111110001101010000001
		1100000111010111111110111110111000011
		11000111111011111111111 111110100011
		11111111 11111111111111 111111111111