NO ./path_to_the_north_texture.xpm

SO ./path_to_the_south_texture.xpm

WE ./path_to_the_west_texture.xpm

EA ./path_to_the_east_texture.xpm

F 20,100,0
C 225,30,244

111111
100101
101101
100001
100N01
111001
111111