NO ./images/wall.xpm
SO ./images/wall.xpm
WE ./images/floor.xpm
EA ./images/floor.xpm

F 250,250,230
C 205,0,230

111111
100001
100101
101101
100S01
100001
111001
111111