NO ./path_to_the_north_texture.xpm

SO ./path_to_the_south_texture.xpm

WE ./path_to_the_west_texture.xpm

EA ./path_to_the_east_texture.xpm

F 220,108,9

C 225,30,255





111111
100101
101001
1100N1
100001
11111
 
111111
