NO ./path_to_the_north_texture.xpm

SO ./path_to_the_south_texture.xpm

WE ./path_to_the_west_texture.xpm

EA ./path_to_the_east_texture.xpm

F 12,25,0
C 195,130,24

111111
100001
100101
1100N1
100001
11111
111111